1111111111111111
10P0001C000E0001
1011111111111001
1111111111111111