1111111111111111
1000000000000001
1011111111111001
101C000000C00001
1010101010101001
1010000000001001
1E10P11111110001
1011111111111001
1000000000000001
1011111111111101
1010000000000001
101C000000C10001
1011111111111001
1000000000000001
1111111111111111
