1111111111111111
1000000000000001
101C000000000C01
1010101010101011
1010P000C0000001
1010101010101011
1010000000000001
1010C000000C0001
1000000000000001
1011111111111001
1010C00000000001
1010000000001001
1011111111111101
1000000E00000001
1111111111111111
