1111111111111111
1000000000000001
1011111111111001
101C000000C00001
1010101010101011
1010000000000001
101P000000000001
1010101111111011
1010000000000001
100000000000C001
1011111111111011
1010000000000001
1000E00000000001
1111111111111111
