11111111111111111111111111111111111111111111
10000010000000000000000000000000000000000001
1P0001C0000000000000E00000000000000000000001
10000000000000000000000000000000000000000001
10000001000000000000000000000000000000000001
11111111111111111111111111111111111111111111