111111111111111
100000100000101
1P0001C000001E1
100000000000101
100000010000101
111111111111111