111111111111111
100000100000001
1P0001C000000E1
100000000000001
100000010000001
111111111111111